White Clinton ---> WHC
BARNIER Belinda --> BAB
PANGALLO Frank ---> PAF
SESELJA Zed ---> SEZ
THOMPSON Phil ---> THP
LOMBARDO Luciano --> LOL
BURKE Jacqui --> BUJ
KENT Gary ----> KEG
HANSON Jeremy ---> HAJ
FARRELL Tony ---> FAT
TARANTO Kerri ---> TAK
TANNAHILL Greg ---> TAG
CROSS Helen ---> CRH
O'NEILL Ben ---> ONB ---> Ben
ALLEN Joanne ---> ALJ
MULCAHY Richard ---> MUR
ROWLAND Stephen ---> ROS
CUMBERS David ---> CUD
GREEN Stuart --> GES
EVANS Kim ---> EVK
LABURN Angus ---> LAA
SEDDON Anthony ---> SEA
VOGT Norvan ---> VON
HOPPER Alvin --> HOA
SADDLER Owen ---> SAO
SCHERGER Nancy-Louise ---> SCN
McALARY David ---> MCD
PINKERTON David --> PID
RATTENBURY Shane ---> RAS
Le COUTEUR Caroline ---> LEC
KIRSCHBAUM Elena ---> KIE
HETTINGER Mike ---> HEM
CORBELL Simon --> COS
BARR Andrew ---> BAA
CROSSMAN Louise ---> CRL
GALLAGHER Katy ---> GAK
MATHEWS David ---> MAD
BATES Eleanor ---> BAE
JONES Giulia ---> JOG
O'NEIL Darren  ---> OND ---> Dar

2008, Molonglo, Assembly 
